01111110
110D0010
10BDB110
100DB010
10BD0P10
10BDB110
110D0100
11111100