11111111
10010011
10P0B0D1
10111011
1000D011
10B00011
10000011
11111111