00111100
001P0100
1110B100
10BBD110
10BDD010
10BDD010
10001110
11111000

