11111111
1000D001
10P0B001
1000B0D1
10000011
10D0B001
10000001
11111111