11111111111111111111
P010000000000001000E
10111111111011111001
10000010000010100001
10111010111110101111
10001010001000100001
10101011101010111001
10101000101010100001
10101110101011101111
10101000101000001001
10101011101011111001
10001000001000001001
10101111111111101001
10100000000000100001
10111110111111111001
10100000100010000001
10111111101010111111
10000000001000000001
10000000001000000001
11111111111111111111
